NO ./textures/texture2.png
SO ./textures/texture1.png
WE ./textures/texture3.png
EA ./textures/texture1.png

F 194, 147, 96
C 116, 221, 232

11111111111111111
10000000000000001
10S00000000000001
10000000000000001
10000000100000001
10000000100000001
10000000100000001
10000000100000001
10011111111111001
10000000100000001
10000000100000001
10000000100000001
10000000100000001
10000000000000001
10000000000000001
11111111111111111
