NO ./textures/texture1.png
SO ./textures/texture4.png
WE ./textures/texture3.png
EA ./textures/texture2.png

F 245, 209, 129
C 255, 243, 255

1111111111111111111111111111111111111111111111111
1001000010001000100010001000100010001000100010001
1010001010101010101010101010101010101010101010001
11000010001000100010001000100010001000100010000N1
1111111111111111111111111111111111111111111111111